35353535353535353535353535353535353535353535353535353535353535353535353535353535353535353535353535353535353535353535353535353535353535
35464646464635464646464646463546354635463546464646464646464635463546354646464646464646464646354635463546354635463546354635464646464635
35463546353535463546353535463546354635463546353535463546353535463546353535353546354635463546354635463546354635463546354635463546353535
35463546464646464646354646464646464646464646464635464646464646464646464635464646354635464646464646464646464646464646464646464646464635
35353546353535463535354635463546354635463546354635353546354635463546354635463546354635353546353535463546354635463535354635463546354635
35464646464635464646464646464646464646464646464646463546464646463546464646464646464646464646354646464646354646464646354646464646464635
35463546354635463535354635463535354635463546354635463546354635353546354635463546354635353546354635463546353535463546354635463546354635
35464646464646464646354646463546464646463546464646464646354646464646464635464646464646463546464646464646464646464646464635464646464635
35463546354635463546354635463546354635353535354635463535353535463546354635353546354635463546354635463546353535463546353535353546354635
35463546354646464646464646464646464646463546464646464646354646464646464646464646464646464646464646464646464646464646464646464646464635
35353546353535463546354635353546354635463546354635463546354635463546354635353546354635463546354635463546354635463546353535463546354635
35464646354646464646464646464646464646464646464646463546464646464646354646464646354646464646464635463546464646464646464635463546464635
35463546354635463546354635353546354635463546354635353546354635463535354635463546353535463546353535463535354635463546354635463535354635
35464646464646463546464646464646464646464646354646464646464646463546464646464646464646464646464635464646464635464646464646464646464635
35463546354635463535354635353546353535463535354635463546354635353546354635463546353535463546354635463546354635353546354635353546354635
35464646354646464646464646464646354646464646464635464646464646464646354635463546464646464646464646464646464646464646464646464646464635
35463546353535463546354635463535354635463546354635353546353535353546354635463546354635463546354635353546353535353546354635463546353535
35463546464646464646354635463546464646464646464635464646464635464646464646464646354646464646354635464646464635464646464635464646464635
35353546354635463535354635463546354635463546353535463546354635463546354635463535353535463535354635463546354635463546353535463546354635
35463546464646464646464646464646464646463546464646464646464646464646354646464646354646464646464646464646464646464646464646463546464635
35463535354635463546354635463546354635353546354635353535354635463546353535463546354635463546353535463546353535463535353535463535354635
35464646464646464646464635464646464635464646464646463546464646463546354646464646464646464646464646464646464646464646354646464646464635
35353546354635463546353535463546353535463535354635353546354635463546354635463546354635463546354635463546353535463546354635463546354635
35464646464646463546354646464646464646464646464635464646464646464646464646464646464646464646464646464646354646464646464646464646464635
35353546354635463546354635463546354635463535353535463546354635463546354635463546353535463546354635463546354635463546354635463535354635
35464646464646464646464646464646354646464646354646464646464646464646464646464646464635464646464635464646464646464646464646463546464635
35463546354635463546354635353535353535463546354635463546354635463546354635353535354635353546353535463546354635463546354635463546354635
35464646354646464646464646463546464646464646464646464646354635464646464646463546464646464646464635463546464646463546354635464646464635
35463546353535463546354635463546354635353535354635463535354635353546354635463546354635463546354635463535354635353546354635463546354635
35463546464646463546464646464646464646463546464646464646464646464646464646464646464646463546464646464646464646464646464646464646464635
35353546354635353535354635463546354635463546354635463535354635463535354635463546354635353546354635463535354635463546354635463546353535
35463546464646464646354646464646464646464646464646464646354635463546464646463546464646464646464646463546464646464646354646464646464635
35463535354635463546353535463546354635463546354635463546354635463546354635353535354635463546354635353546354635463546353535463546354635
35464646464646464646464646463546354635464646464646464646464646464646464646463546464646463546464646463546464646463546464646463546354635
35353546354635463546354635353546354635353546354635463546354635463546354635463546354635353535354635463546354635353546354635353546354635
35464646464646464646464646464646464646464646464646463546464646464646464646464646464646464646464646464646464635464646464646464646464635
35353535353535353535353535353535353535353535353535353535353535353535353535353535353535353535353535353535353535353535353535353535353535
