27 1
###################################################################
##......#.....#.......#...#.........#.........#...#...........#...#
#######.......#.#.###.#.###.###.###.#.##......#.#.#####.#####.#.#.#
#.....#.......#.#.#.#.#.....#...#.#.#.#.........#.......#...#.#.#.#
###.#.#.......###.#.#.#######.###.#.#.#.###.#####.#####.#.#.###.#.#
#...#.............#.#.#...#...#.#...#.#...#...#.#.#.......#.....#.#
#######......######.#.#.#.#.###.#.###.###.###.#.#.#.#.....#######.#
#.......#...........#...#.#...#...........#...#...#.#.......#.#...#
###.###.#.#########.#####.#.#.###.........#.#######.#.....#.#.#.###
#.....#...#...#.............#.............#...#.....#.....#...#...#
###.#.#####.###.########.......##.........###.#.#####.....#.#####.#
#...#.....#...#.#.#.........................#...#.....#.#.#.#.....#
###.#####.###.#.#.#.###.........#.....#####.#########.#.###.#.###.#
#.....#.#...#.....#.#.#.........#.#.........#.......#.#...#.#.#.#.#
#####.#.###.#####.#.#.##........###########.#.#####.#.###.#.#.#.#.#
#.....#...#...#...#.....#.....#...#...#...#.#...#.#.....#...#.#.#.#
#.#####.#.###.###.#####.#.###.#.#.#.#.#.#.#.#.#.#.#####.#####.#.#.#
#.#.....#...#...#.....#.#.#...#.#.#.#.#.#...#.#.#.#...#.#.....#.#.#
#.#####.###.###.#####.#.#.#.#####.#.#.#.#######.#.#.#.#.#.#####.#.#
#.....#...#...#.#...#.#...#...#...#.#.#.#.......#.#.#...#.#.....#.#
#####.###.###.#.#.#.#########.#.###.#.#.#####.###.#.#####.#.#####.#
#...#.#.....#.#...#.......#.#.#.....#.......#...#.....#...#...#...#
###.#.#.#####.#######.###.#.#.#############.###.#######.#####.#.###
#.....#.#.....#...#...#...#.#.........#...#.#...#.......#...#.....#
#.#####.#.#####.#.#.###.###.#########.#.###.#.###.###.###.#.#.#####
#...#...#.........#.#.......#.......#.#...#.#...#...#.#...#.#.#...#
###.###.#.#######.#.#######.#.#.###.#.#.#.#.###.###.###.###.###.#.#
#.....#...#.....#.#...#...#.#.#.#...#.#.#.........#.......#...#.#.#
#####.###.#.....#.###.###.#.#.#.###.#.###################.###.#.#.#
#...#...#.#######...#...#...#.#...#.#...#.........#.....#.#.#...#.#
###.###.#.........#.###.###.#.###.#####.#.#######.#.###.#.#.#####.#
#.....#.........#.#.#.#...#.#.#.#.....#.#.....#.....#...#.....#...#
#.#.#############.#.#.###.###.#.###.###.#####.#######.#########.#.#
#.#...#...#.......#...#.#.#...#...#...#.....#...#...#.....#.....#.#
#.###.#.#.#.#.#######.#.#.#.###.#.###.#####.###.#.#.#####.#.#####.#
#...#...#...#...........#.......#...#...........#.#.........#.....#
###################################################################
