27 1
###################################################################
#.....#.#.........#...#...#.......#.........#.......#.....#.......#
#.#.#.......###.#.#.#.#.#.#.#.###.#.#.#####.#.#####.#.###.###.###.#
#...#...........#.#.#...#...#.#...#.#...#.#.#...#.#...#.#.#...#.#.#
#####.......#####.###########.#.###.###.#.#.#.......###.#.#.###.#.#
#...#.#...#.#...#.............#...#.#...#.#.#.......#.....#...#...#
#.#.#.#.###.#.#.#######.......###.###.###.#.#.......#.#####.#.#####
#.#.#.#.#...........#...........#.....#...#.#...#...#.#.....#.#...#
###.#.###.#.......#.#.#.......#.#######.###.#.###.#.#.#######.#.#.#
#...#.....#.........#.#.......#.#...#.....#...#.#.#.#.#.......#.#.#
#.#.#######.......#.#.###.#.#.#.#.#.#.###.#####.#.#.#.#.#####.#.#.#
#.#...#...#.......#.#.#.#.#.#.#...#.#...#.#.....#.#.#.#...#...#.#.#
#.###.#.#.#.......###.#.#.#.#.#####.###.#.#.###.#.#.#.#.#.#####.#.#
#...#.#.#...#.#...#...#.#.#.#.#...#.#...#...#...#.#...#.#...#...#.#
###.#.#.#####.#.###.###.#.#.#.#.###.###.#####.###.#######.#.#.###.#
#...#.#.....#.#...#.#...#...#.#...#...#.....#...#.......#.#.#...#.#
#####.#.#####.#####.#.#######.###.###.#####.###.#######.#.#.###.#.#
#.....#.#.....#.....#.#.............#.#.#...#.#.#.......#.#.....#.#
###.###.#.###.#.#####.#.#############.#.#.###.#.#.###############.#
#.....#.#...#.#.#...#...#.#...........#.#.#...#.#.#...#...........#
###.#.#.###.###.#.#.#.###.#.###########.#.#.###.#.#.#.#.#########.#
#...#...#.#...#.#.#.#.#...#...............#...#...#.#...#...#...#.#
###.#####.###.#.###.#.#.#######.########.##.#.#####.#####.#.#.#.#.#
#.......#.#...#...#...#.....#...#......#..#.#.#...#...#.#.#.#.#.#.#
#######.#.#.#####.#.#######.#.#.#......#..#.#.#.#.#.#.#.#.#.#.#.#.#
#.....#...#.#...#.#.#.......#...#......#....#...#...#.#.#.#...#.#.#
#.#.#.###.#.#.#.#.#.#.#.#######.#......#.############.#.#.#####.#.#
#.#.#.#...#.#.#...#...#.#.......########..............#.#.#...#.#.#
###.###.###.#.###########.#####..........##############.#.#.###.#.#
#.....#.#...#.#...#.......#.#...#.#...........#.....#...#.#...#...#
#.###.#.#.###.#.#.#.#######.#.#.#.###########.#####.#.#.#.###.#####
#...#...#...#...#...#.......#.#...#...........#.....#.#.#.....#...#
###.#######.#########.#######.#####.###########.###.#.#.#####.#.#.#
#...#.#.......#...#...#...#...#.....#...#.....#...#.#.#.......#.#.#
#.###.#.#######.#.#.#.#.#.#.#######.#.#.#.#.###.#.###.###########.#
#.....#.........#...#...#...........#.#...#.....#.................#
###################################################################
