27 1
###################################################################
##....#.#.......#.................#.......................#...#...#
#####.#.#.#.###.#.#####.####.........##.###.....#########.#.#.#.#.#
#...#.#.#.#...#.#.#...#...#...........#.#.#.............#.#.#...#.#
###.#.#.#.###.###.#.#......#.........##.#.#.....#######.#.#.#####.#
#...#.#.............#...................#.........#...#.#.....#...#
###.#.#.......########......#.##.....####.###.#####.#.#.#######.#.#
#...#.#.....................#...#.#.....#...#...........#.......#.#
###.#.##......###.####......##.....####.######.......####.#######.#
#...#.#.......#...#...................#...............#.#.....#...#
#.#.#.#.......#####.#####.###.......#########.........#.#.###.###.#
#.#...#.#.........#.#...#...#.......#.................#.#.#.#...#.#
#.#####.#.#######.#.#.#.#.#########.#.########.......##.#.#.###.#.#
#.#.....#.....#...#.#.#.#.....#.....#...#...#.......#...#...#...#.#
#.#.#.#######.#.###.###.#####.#.#######.#.#.#.#########.#.###.###.#
#.#.#.....#...#.............#...#.....#.#.#.#.#.........#.#...#.#.#
#.#####.#.#.###################.###.###.#.#.#.#.#####.###.#.###.#.#
#...#...#.#...#...............#...#...#.#.#...#...#.#.....#...#...#
###.#.###.###.#.#############.###.###.#.#.#######.#.#########.###.#
#...#...#...#.#.......#...#...#.#.....#.#...#...............#...#.#
###.###.#####.#######.#.#.#.###.#.#####.###.#.#############.###.###
#...#...#...#.........#.#.#.#.....#...#...#.#.#.......#.#.....#...#
###.#.###.#.#.#######.###.#.#######.#.###.#.###.#####.#.#.#######.#
#...#...#.#.#.#.....#.....#.........#.....#.....#.#...#...#.......#
#.#####.#.#.#.#.....#.#.#########################.#.#######.#####.#
#.....#...#...#.....#.#.........#...#.....#...#...#.#.......#.#...#
#####.#######.#######.###.#.###.#.#.#####.#.#.#.#.#.#.#######.#.###
#...#...#...............#.#...#...#...#...#.#...#...#...#.......#.#
###.###.#.#########.###.#.###.#######.#.#.#.#########.#.#######.#.#
#.....#.#.#.....#.......#...#...#...#...#.#.#.......#.#.......#...#
###.###.#.#.###.###########.###.#.#.#####.#.#.#####.#.#######.###.#
#.....#.#.....#...#.......#.#.#.#.#...#...#...#...#.#.#.....#.#...#
#.###.#.#########.###.#.###.#.#.#.###.#.#########.#.#.###.#.#.###.#
#.#...#.#...#...#...#.#...#...#.#...#.#...........#.#.....#.#...#.#
#.#.###.#.#.#.#.###.#.###.###.#.###.#.#############.###########.#.#
#.#.......#...#.....#...#.....#.....#...........................#.#
###################################################################
