27 1
###################################################################
##....#...........#.............#.......#...#.....#.......#.......#
#####.#.###.#####.#.#.#########.........#.#.#.#.###.#.....#######.#
#...#.#.#...#...#.#.#.....#...#.........#.#.#.#.#...#.............#
###.#.#.###.#.#.###.#####.###.##.......##.#.#.#.#.####....#######.#
#...#.#...#.#.#...#.........#.............#.#.#...#...........#.#.#
#.#.#.#.#.###.###.##........#........######.#.#####.##......#.#.#.#
#.#.#.#.#...#...#...........#.............#.#.#.#...#.......#.#.#.#
#.#.#.#####.###.###.........#........####.#.#.#.#.###.......#.#.#.#
#.#...#.......#...#.#.#...#.#.........#...#.#.#.#.#.........#...#.#
#.#####.#####.#.........#.#.######......###.#.#.#.#.#####.#.###.#.#
#...#...#.....#.#######...#...#.#.......#.......#.#.......#...#.#.#
###.#.#########.#.....#.#####.#.#......##########.#######.###.###.#
#...#...........#.....#.......#.#.#.............#.....#.#.#.#...#.#
###.###########.#######.#######.#.#.#.#########.#####.#.#.#.###.#.#
#.......................#.......#.#.#...#.....#.#.....#...#...#...#
###############################.#.#.###.#####.#.#.#####.#####.#####
#...#...............#...........#.#.#.#...#...#.#.#...#.#.....#...#
#.#.#.###.###.#####.#.###.#####.#.#.#.###.#.###.#.###.#.###.#.###.#
#.#.#...#...#.#...#.#.#.#...#...#.#.....#.#...#.#...#.#.#...#.....#
###.###.###.#.#.#.###.#.###.###.#.#######.###.#.#.#.#.#.#.#######.#
#.....#...#.#.#.#.#...#...#...#.#.........#...#.#.#.#...#.#.....#.#
#.###.###.#.#.#.#.#.###.#.###.#.###########.###.###.#.###.#####.#.#
#.#.#...#.#.#.#.#...#...#.#.#.#.#.....#.....#...#...#...#...#...#.#
#.#.###.#.#.###.#####.###.#.#.###.#.###.#.###.###.#####.###.#.###.#
#.....#...#...........#.....#.....#.....#.........#.........#.....#
###################################################################
