27 1
###################################################################
#.......................#.................#...#.............#.....#
#.###....##.#########.###.#.###########.###.#.#.#.#......##.#.#.###
#.........#.#...#.....#...#.#.....#.....#...#...#.#.......#.#.#...#
#####.....###.#.#.#####.###.#.#.....#####.#######.#.......###.###.#
#.........#...#.#.......#...#.#...........#...#...#.....#.......#.#
#####.....#.###.##......#.###.#.....#.....###.#.#######.#.#######.#
#.......#.#...#.........#...........#.......#.#.#...#.........#...#
###.#...........##......#######.#.#.#.....#.#.#.#.###......##.#.#.#
#........######.#.......#...#...#...#.....#.#.#.#.............#.#.#
#.###....#....#.#.......#.#.###.#######.###.#.#.###.#########.#.#.#
#.#......#....#.......#...#...#.....#.#.......#...#.........#.#.#.#
###.###..#....#.#.....#######.#####.#.###########.#########.#.#.#.#
#.....#..#....#.......#.....#.#.....#...#.........#.#.....#.#.#.#.#
#####.#..######.#######.#####.#####.#.#.#.#########.#.#.###.#.#.###
#.....#.............#.......#.....#...#.#...#.........#...#.#.#...#
#.#.#####.#.#.#.###.#######.#####.#########.###.#######.#.#.#.###.#
#.#.......#...#...#.......#.....#.........#...#.#.....#.#.#.#...#.#
#################.#.#####.###.#.#########.#.#.#.#.###.#.#.#.#####.#
#.............#...#.#...#.....#...#.....#.#.#.#.#.#...#.#...#.....#
#.#.#########.#.###.#.#.#########.#.#.###.###.###.#.###.#####.###.#
#.#...#...#.....#.#.#.#...#...#...#.#...#...#.....#...#...#.#...#.#
#.###.#.###.#####.#.#.###.#.#.###.#.###.###.#########.###.#.#.#.###
#.#...#.....#...#...#.#.#...#...#.#.#.#.....#.........#...#...#...#
#.#.#########.#.#####.#.#######.###.#.#######.#########.#########.#
#.#...........#...............#...............#...................#
###################################################################
