27 1
###################################################################
#...#...........#.....#.........#.....#.........................#.#
#.#.#.###.#######.#.#.###.#####.#.#####.#############.#########.#.#
#.#.....#.........#.#.....#...#.#.........#.........#.....#...#.#.#
#.##########......#.###.#####.#.#####.....#.#######.#####.#.###.#.#
#.................#...#.#...#.............#.#...#.........#.....#.#
#################.#.#.###.#.#########.....#.#.#.###########.#####.#
#.............#...#.#.....#.....#.....#...#...#...#...#...#.#.....#
###.###......##.###.###########.###.....#.#.#####.#.#.#.#.#.#.###.#
#.............#.#.............#.........#.#.#.....#.#...#.#.#...#.#
#.#####.#.###.#.#############.#####.....#.#.#.#####.#####.#.###.#.#
#...#...#.#.#.#.............#.....#...#...#.#.#.......#...#...#.#.#
###.#.#.#.#.#.#######.......#########.#.###.#.#####.#.#######.#.###
#...#.#.#.#.#.........#####.........#.#...#.#.....#.#.........#...#
#.###.###.#.#########.#...#.#######.#.###.#######.###########.###.#
#...#...#.#...#...#...#...#.#.....#.#...#.......#...........#.#...#
###.###.#.#.#.#.#.#.#.#...#.#.#.###.#.#.#######.###########.#.#.#.#
#...#.#.#...#...#.#.#.#####.#.#...#.#.#.......#...#.........#...#.#
###.#.#.#.#########.#.......#.###.#.#.#######.###.#.#############.#
#...#.#.#.#.........#.#.......#.#...#...#...#...#...#.....#.....#.#
#.###.#.#.#.#########.#.#######.#######.#.#####.###.#.###.#.#####.#
#.....#...#.......#...#.#...#.......#...#.....#.#...#.#...#.....#.#
#####.###########.#####.###.#.#.#####.#######.#.#####.#.#####.#.#.#
#...#.#.....#.....#.....#...#.#...#...#.......#.......#.....#.#...#
###.#.#.#.###.###.#.#####.###.###.#.#####.#########.#######.#######
#...#.#.#...#...#.#.#...........#.........#.......#.#.....#...#...#
###.#.#####.###.#.#.#####################.#.#####.#.#.#######.#.#.#
#...#.#.....#.#.#.#.........#...........#.#.#...#.#.#.......#.#.#.#
#.#.#.#.###.#.#.###########.#.#########.###.#.###.#.#####.###.#.#.#
#.#.#.#...#...#.........#.#.#.#.....#.#.....#...#.#.#...#...#...#.#
#.#.#.###.###.#####.###.#.#.#.#.###.#.#######.#.#.#.#.#.###.#####.#
#.#.#.....#...#.....#.#.#.#.#.#.#.#.#.....#...#...#...#...#...#...#
###.#######.###.#####.#.#.#.#.#.#.#.###.###.#############.#.#.#.###
#.........#.#.#.....#.....#.#.....#...#...#...#.......#.....#.#...#
#.#####.###.#.#####.#######.#########.#.#.###.#.#####.###########.#
#.....#...........#...................#.#.......#.................#
###################################################################
