27 1
###################################################################
##..........#.................#...#...............................#
###########.#.###############.#.#.#.#####.#####........########.#.#
#...#.....#.#...#...........#.#.#...#.....#...#.................#.#
###.#.#.###.#.#.#########.###.#######.#######.##........#########.#
#...#.#.....#.#...#...........#.....#.......#...............#...#.#
#.#.#.#######.###.#.......###.#.###.####....###........####.#.#.#.#
#.#.#.....#.#...#...........#...#.#...#...............#...#.#.#.#.#
###.#####.......#.........#.#####.###.#.....###.......#.#.#.###.#.#
#...........................#.......#...#.....#.........#.#.#...#.#
###.#...........#.........#######.#.#########.###.#.#######.#.###.#
#...#...........................#.#.......#...#...#.#.......#...#.#
#####........####.#.#.#########.###.###.###.###.###.#.#######.#.#.#
#............#..#.#.#.....#...#...#...#...#.#.....#.#.......#.#...#
#.#.#........#..#.#.###.#.#.#####.###.###.#.#####.#.#######.###.###
#.#.#.#.#.#..#..#.#.#...#.#.....#.#.#.#.#.........#.#.....#...#...#
#.#.###.#.#..####.#.#.###.#####.#.#.#.#.#######.###.#####.###.###.#
#.#.#...#.#.........#...#...#...#.#.....#...#.#.#...#.......#.#...#
###.#.###.#############.###.#.###.#####.#.#.#.#.#.###.#######.#####
#.....#.................#.#.#...#...#...#.#.#...#.#...#.....#.....#
#.#######################.#.###.###.#####.#.#####.#.###.###.#####.#
#...#.......#.........#...........#.#.....#.....#.#...#...#.#.....#
###.#.#.###.#.#######.#.###########.#.#########.#.#.#.###.#.#.#####
#...#.#.#.#.#...#...#.#.#.....#...#.....#.......#.#.#.....#.#.....#
#.#####.#.#.###.#.#.#.#.#.###.#.#.#######.#####.#.#####.###.#####.#
#.......#.#.....#.#.#.#.#...#.#.#.......#...#...#.....#.#...#...#.#
#########.#########.#.###.#.#.#.#######.#.#.#########.###.#.###.#.#
#.....#.............#...#.#.#...#.....#.#.#...............#.....#.#
###.###.#####.#########.###.#########.#.#.#######################.#
#.......#...#...#.....#.....#.......#.#.#...#.....#...............#
###.#######.###.#.#.#############.#.#.#.###.#.###.#.#############.#
#...#.#.......#.#.#.....#.........#...#.#.#.#.#...#.....#.......#.#
###.#.#.#.###.#.#.#####.#.#.#####.#####.#.#.#.###.###.#.###.###.#.#
#...#...#...#.#.#.....#.#.#...#...#.....#...#...#...#.#...#.#.#.#.#
###.#######.#.#.#####.#.#.###.#####.###########.###.#####.#.#.#.#.#
#...........#.#.......#.....#...................#.........#...#...#
###################################################################
